...###
..##.#.##
.##..###.
##.......
#...@..#.
###..###.
..#..#...
.##.##.#.
.#......#
.#.....##
.#######