....##....
...#...##.
#.#..##EE#
.#.#..EEE.
#E..##EEE.
#.#.E..EE#
#.###.#...
#E.#.#.#.#
##.E.E.E#.
.#######.E