##########
#.........
#.........
#.........
#.........
#.........
#.........
#.........
#.........
#......#..