...###
..##E#.##
.##..###.
##.....E.
#...@..#.
###..###.
..#..#...
.##.##.#.
.#......#
.#.....##
.#######