.#..#.#.#.
.##.#..#..
#...E#E.##
.E.#.#.##.
.EEEE.....
###EE#.##.
.......#..
##.#.#..#.
.#E###E#.#
#.##E##...