##########
..........
..........
..........
..........
..........
..........
..........
..........
...#.#....