.........#
.........#
.........#
.........#
.........#
.........#
.........#
.........#
#........#
.#########